{
  "name": "Intro-2",
  "hex_size": 24,
  "radius": 3,
  "mines": [
    [-3, 1],
    [-3, 2],
    [-2,  0],
    [-1,  2],
    [ 1,  1],
    [ 1,  2],
    [ 2, -1],
    [ 2,  1]
  ],
  "blocked": [
    [-3,  3],
    [-2,  3],
    [-1, -2],
    [-1,  3],
    [ 0, -3],
    [ 0, -2],
    [ 0,  3],
    [ 1, -3],
    [ 1, -2],
    [ 2, -3],
    [ 2, -2],
    [ 3, -3],
    [ 3, -2]
  ]
}